111111111111
100000000101
10000E000111
10P000000001
111111111111