111111111111
100000C001C1
100000CCC111
10P000000001
111111111111