111111111111
100000C001C1
10000ECCC111
100000000001
111111111111