111111111111
1000C000E001
000000000001
100000C0C011
111111111111