1111111111111111111
1100C000E000000000011111
1000000000000000000000011
1000000000000000000000011
11111111111111111111111