11111111111111111111111111111111111111111111111111111111111111111111111111111111
10000000000001C11000000000P00000000000000000000000000000000000000000000000000111
100001010101000000E100000000C1000C1C00000000000000000000000000000000000000000111
100000000000C0C00C000C10000001C0000000000000000000000000000000000000000000000001
10000000000001C11000000000C00000000000000000000000000000000000000000000000000111
10000000000001C110000000001C0000000000000000000000000000000000000000000000000111
110000001C000C111110000000000C1C1C1C10000000000000000000000000000000000000000001
1000000000000000001C110000C00000000000000000000000000000000000000000000000000111
11111111111111111111111111111111111111111111111111111111111111111111111111111111