111111111111
100000C0C011
1E00001000J1
100Z01111001
111111111111